Abdallah	Zachery	
Achor Zyad	Tariq	check here
Acosta	Andrea	
Adams	Micheal	
Adesiyun	Monboluwarin	
Agu	Chukwuemeka	
Aguayo	David	
Ahmad	Nauman	
Ahmed	Muzzammil	they tried
Al Hilfi	Abdullah	
Albadri	Mayasa	they tried
Alexander	Noah	
Ali	Syed	
Alvarado	Maximiliano	
Alvarado-Calderon	Angel	
Andrews	Austin	
Aneke	Josh	they tried
Animadu	Tony	they tried
Ansari	Ariya	
Arefeen	Zarin	
Armansyah	Samantha	
Asif	Zeeshan	
Ayala	Marcos	
Bernal	Julio	
Berry	Courtney	
Blanke	Tyler	
Bonilla	Ariel	they tried
Bui	Viet	
Bustos	Jose	
Cachutt	Diego	
Cagle	Ein	
Cardenas	Lucas	
Carlisle	Charles	
Casbeer	Jason	
Cashman	Ray	
Casillas	Luis	
Castaneda	Alexandra	
Castillo	Anthony	
Castillo	Jonathan	they tried
Castro	Andrew	
Cecilio	Armando	
Cervantes	Daniel	
Chacon	Andres	
Chaleckis	Andrew	
Chen	Ming-Kai	check here
Corrallo	Dayne	
Crain	Jeremy	
Cruz	Alejandro	check here
Cruz	Anthony Arthur	
Dada	Ammar	they tried
Daugherty	Nicklas	they tried
Delheimer	Zackary	check here
Dhar	Siddhant	they tried
Diep	Johnny	check here
Do	Patrick	
Do	Thang	they tried
Doan	Anthony	
Donato	Jack	
Dos Santos	Angelo	
Earll	Ryan	
Eclarin	Jv Kyle	
Ellis	Andie	
Escosura	Matthew	
Evans	William	
Ezeaju	Ikenna	
Farinha	Russell	check here
Figueroa	Jennifer	
Flores	Felipe	check here
Folh	Joshua	they tried
Foster	Russell	
Frizzell	Jake	
Garcia Dominguez	Juan	they tried
Garcia	Zach	
Garza	Darren	they tried
George	Danny	they tried
Gonzalez	Giovanni	
Gonzalez	Jordan	
Green	Warren	
Guo	Yixin	
Gutierrez	Luis	
Haaksma	Joseph	
Harris	Zach	
Hernandez	Eric	
Higo	Katsumi	they tried
Hilton	Dylan	
Hines	Gwyn	
Ho	Alexander	they tried
Hoang	Bryan	they tried
Hoang	Nicholas	check here
Hoang	Ryan	check here
Holcombe	Matthew	
Hoover	Zachary	
Ingram	Pierre	
Issa	Mohamed	
J	Jerry	they tried
Jalilova	Jeyla	
Javed	Wahab	
Jawaid	Ahad	
Jin	Zhihao	
John	Jeff	check here
Johns	Aaron	
Jones	Jurnae	
Juel	Kallie	
Kadiwal	Saif	they tried
Kalathiya	Krunal	they tried
Kaya	Hidayet	
Keough	Myles	
Khan	Mohammad	
Khilani	Nathan	they tried
Koepke	Ross	
Kose	Emir	they tried
Koslin	Tamar	
La	Andy	check here
Lacey	Galvin	
Le	Danny	they tried
Le	Ngan	they tried
Le	Nicholas	
Le	Phu	
Lehaci	Sabin	check here
Levy	DJ	
Li	Ying	
Liang	Jun	they tried
Lim	Jennifer	they tried
Limbrick	Antwon	
Lin	Evan	
Lin	Jiazhen	
Lindhardt	Jeremy	
Lojero	Brandy	
Machen	Jonathon	
Macias	Anthony	they tried
Mahale	Tej	
Maknojia	Ziyan	check here
Malik	Mohammed	they tried
Mallorca	Klyde	
Mang	Joshua	they tried
Mangan	Cole	
Mansuri	Zara	
Marquez	Matthew	
Marroquin	Luis	
Martinez	Genesis	
Martinez	Lizandro	
Mascarenhas	Rodrigo	
Merida	Nicholas	they tried
Mike-Irabor	Osahon	they tried
Miller	Ayrton	
Mishra	Eshupriy	
Mlinka	Samuel	they tried
Moid	Shayan	check here
Molina	Carlos	
Montemayor Alvarado	Anthony	
Montemayor	Jacob	
Montes	Narciso	
Moore	Javonte	they tried
Morgan	Corey	
Munoz	Jacqueline	
Nguyen	Courtney	check here
Nguyen	Crystal	
Nguyen	Dalila	
Nguyen	Ethan	
Nguyen	Hai	
Nguyen	Jessica	they tried
Nguyen	Nhat	
Nguyen	Noah	
Nguyen	Sean	
Nguyen	Thach	
Nguyen	Vinh	
Nguyen	Xavier	
Obajemu	Joseph	they tried
Ochoa	Kevin	
Odjighoro	Akpevwoghene	they tried
Odjighoro	Ejiroghene	
Oladipo	Tofi	they tried
Olivier	Kyle	
Olumese	Dion	they tried
Onyejelem	Henry	check here
Orak	Muhammed	
Orellana	Fredy	they tried
Orji	Chisom	
Ortiz	Kobe	
Osegueda	Elvin	
Ozen	Muzaffer	they tried
Palma	Henry	
Patel	Bhavik	
Patel	Ria	
Perez	Bryan	
Perez	Mario	they tried
Pham	An	
Pham	Eric	
Pham	Erick Khai	they tried
Pham	Tyler	they tried
Phan	Nguyen	they tried
Phung	Kevin	
Plata	Heber	
Portillo Garay	William	
Powers	Stephenson	
Prasla	Razin	
Rabano	Grace Anne	check here
Rahman	Rayyan	
Ramos Bautista	David	
Rebeles	John	
Reimers	Conner	
Resendez	Nicholas	
Robertson	Sophie	
Robinson	Allen	
Rodriguez	Carla	
Rodriguez	Joshua	
Rogel	Rafael	they tried
Rosales	Juan	check here
Rouse	Elisabeth	
Saiym	Nurul	they tried
Saucedo	Martin	they tried
Scruggs	Sunny	
Sevilla	Joshua	
Sewielam	Yousef	they tried
Shah	Dhruv	
Shah	Jinangkumar	check here
Shaikh	Yusra	
Sharma	Mitchell	
Sharma	Suryansh	
Shehadeh	Adam	
Siddiqui	Omar	
Silva	Zitlali	
Singh	Ranjoth	they tried
Smith	Nicholas	they tried
Smoot	Noah	
Soares	Jacob	
Sodhi	Kunwar	
Soubaa	Akram	
Strong	William	
Suerte	Jason	
Sunil	Austin	
Syed	Saamiya	
Tan	Justin	
Tasdelen	Mehmet	
Tat	Benjamin	
Taylor	Malik	they tried
Thomas	Philip	
Thomas	Ray	
Torres	Jose	
Tran	Tiffany-Linh	
Tran-Truong	Kenneth	
Trevino	Mario	check here
Tuazon	Mary Yahwehla	
Uang	Wei-Liang	they tried
Uddin	Umer	
Udumala	Jeslyn	they tried
Ulusoy	Ahmet	
Uriarte	Guadalupe	
Uriostegui	Edder	
Van Wyk	Ophelia	
Villalobos Canales	Marvin	they tried
Villegas	Diego	
Viswanathan	Toshani	they tried
Vrba	Harrison	
Vu	Nathan	
Wang	Patrick	they tried
Watad	Omar	
Whitehead	Gage	check here
Willow	Hollie	
Won	Brandon	check here
Yan	Wei	check here
Yanez Jesus	Juan	they tried
Ye	Jihao	they tried
Zeinieh	Grace	
Zequeira	Frank	
Zorrilla	Dante	check here
